1111111111111
10010000000C1
1111011111001
1111011111011
1CCCC11111011
1000011111011
1000011111011
10P011E000011
1111111111111