1111111111111
1C00000000C11
11100P1111001
1111011111011
1CCCC11111011
1000011111011
1000011111011
100011E000011
1111111111111