111111111111111111111111111
1C00000001C000C11111111CCC1
11100011101001100001111C001
11100110100000000001100C1C1
1CCCCP1110000000001101011C1
10000111111111000000CC00C11
10000111110000000001010CC11
100000E000000000000000111C1
111111111111111111111111111