11111111111111111111111111111111111111111111111111
1P0000000000T000000000000000T000000000000000110011
10000000000000T00000001111111000000000000111111101
1111111111000T000000T00000T00000000010000000011001
11111111100000000000011000000000000100000C00000001
111110000011111000000000000T0000000000111111111101
111000000000000111110000000000000T0000010001100001
1111111100000000000011100000000000T000010000000101
111000000000000111111111111000100C00000100000000T1
11000C00T0C00000T00C000E00001100C0000C010000000101
11000C00C0T000T00000C000001100000T11100T0000001101
111111110C00000000000000C10001110111000T000T000101
111000C00000T00000000C0111111101111100T00000011101
1111100C0000000T00001100C001111111100C0000000000C1
111111C1111CC1111000100T00000C0000000CT00000000001
11000000000000T0000000001000000000000C000000000111
1111CCCCCC100000000011111110000000000C0000T0000001
11110000C0000000T000000000000T0000000C00T000000011
11000000T00C00000T000000C00T000000C000000000001111
11111111111111111111111111111111111111111111111111