1111111111111111111111111111111111111111111111111111
1P0000000000T0000000000C00000T00000C0000000000110011
1000000C0000000T000000011111110000000C00000111111101
11111111110C00T00C0000T00C000T00C00000C0010000000001
1111111110C000C00000C00011000000000000100000C0000001
111110000011111000000C000000T01111000001111111111101
1110000000000C001111111111100C00000T0000010001100001
111111110000000C00001110000000C0000T0000100000001011
111000000C00000011111111111100C0100C00000100000000T1
11000C00T0C00000T00C000E00001100C0000C01000000010111
11000C00C0T000T0C000C0C00C0001100000T11100T000000111
111111110C00001111100000C10001110111000T000T00010001
111000C00000T00000000C0111111100001100T0000001110001
1111100C0000000T00001100C001100110100C0000000000C111
111111C1111C1111000100T00000C0111000CT0000000000CTT1
11000000001100T0000000001000000011000C000T00000T0111
1111C100001100011111110000000000C0000T00CTCTCTC00001
11110000C0110000T000000000000T0000000C00T00000CC0011
11000000T01C00000T000000C00T000000C000000000CC001111
1111111111111111111111111111111111111111111111111111