111111111111111111111111111
1C00000000C000C111111110001
111000111010011000011110001
111001101000000000011000101
1CCCCP111000000000110101101
100000000000001000001100111
100001111100000000010100101
100000E000000T0000000111111
111111111111111111111111111