111111111111111111111111111
1C00T00001C000C11111111CCC1
11100011101001100001111C001
111001101000000T0001100C1C1
1CCCCP1110000000001101011C1
1000T000000000100000CC00C11
10000111110000000001010CC01
100000E000T00000000001111C1
111111111111111111111111111