11111111111111111111111111111111111111
100000T000T000000000000000000000000C01
10ET0000000001111111011111111111111101
10T000T00011111111C0011110001111111101
1000000011111110C00001010C001111111101
1000011111111C00T000010000001111111C01
1001111111C000000T0P0000T0111111110001
10111111C00T00000000000111111100000001
101111CCCCCCC0CCCCCC011111110000000001
1T111111111111111111011111110000011101
10111111111111111111011111110001111101
101111111111111111110111T1110111111101
1T0C00000T0001111111000000T00000000001
10T0000T000C01111111011000TC0000000001
10T0T000000C01111111011111111111110001
1CC0T0CCCC0C011111110000000C0000000001
11111111111111111111111111111111111111